13 25
0 0 9 9 9 0 9 9 0 0 0 9 2 
9 0 0 0 9 0 9 9 0 0 0 0 0 
9 0 9 0 0 9 9 0 0 9 0 0 0 
0 9 9 0 9 0 0 9 0 9 0 9 0 
9 0 0 0 9 9 9 9 0 0 0 0 0 
0 0 9 9 9 0 0 0 9 0 9 9 0 
0 0 0 9 0 0 9 0 0 0 0 9 0 
9 9 0 0 9 0 0 9 0 9 9 0 0 
9 9 0 0 0 9 0 9 0 9 9 0 9 
9 0 9 9 9 9 9 9 9 9 9 0 0 
9 0 0 0 0 0 9 9 0 0 0 9 0 
0 9 0 0 0 0 9 9 0 0 9 9 0 
9 0 9 0 0 9 9 9 0 0 0 0 0 
0 0 9 9 9 9 0 0 0 0 0 9 0 
0 9 0 9 9 0 9 0 9 0 0 9 0 
0 9 9 0 0 9 9 0 0 9 9 9 0 
0 0 0 9 0 0 9 0 9 9 9 0 0 
0 0 0 9 9 9 0 9 9 0 0 9 0 
0 0 9 0 9 0 9 9 9 0 9 0 0 
9 0 0 9 9 9 9 9 0 9 0 0 0 
9 9 9 0 0 0 0 9 0 0 9 0 0 
9 9 9 0 9 0 0 0 9 9 9 9 0 
0 0 0 0 9 0 9 0 0 0 0 9 0 
0 9 0 0 9 0 9 9 9 0 0 0 0 
1 0 0 9 9 0 9 0 0 0 0 0 9 
